HeaderAC-MuiAutocomplete-root: header-autocomplete-root
HeaderAC-MuiAutocomplete-hasClearIcon: header-autocomplete-clear-icon
HeaderAC-MuiFormControl-root: header-form-control-root
HeaderAC-MuiTextfield-root: header-textfield-root
HeaderAC-MuiFormControl-fullWidth: header-form-control-full-width
HeaderAC-MuiFormLabel-root: header-form-label-root
HeaderAC-MuiInputLabel-root: header-input-label-root
material-header-root: material-header-root
HeaderAC-MuiInputLabel-formControl: header-input-label-form-control
HeaderAC-MuiInputLabel-animated: header-input-label-animated
HeaderAC-MuiInputLabel-outlined: header-input-label-outlined
HeaderAC-MuiInputBase-root: header-input-base-root
HeaderAC-MuiOutlinedInput-root: header-outlined-input-root
jss5: jss5
HeaderAC-MuiAutocomplete-inputRoot: header-autocomplete-input-root
HeaderAC-MuiInputLabel-fullWidth: header-input-label-full-width
HeaderAC-MuiInputBase-formControl: header-input-base-form-control
HeaderAC-MuiInputBase-adornedEnd: header-input-base-adorned-end
HeaderAC-MuiOutlinedInput-adornedEnd: header-outlined-input-adorned-end
HeaderAC-MuiInputBase-input: header-input-base-input
HeaderAC-MuiOutlinedInput-input: header-outlined-input-input
HeaderAC-MuiAutocomplete-input: header-autocomplete-input
HeaderAC-MuiAutocomplete-inputFocused: header-autocomplete-input-focused
HeaderAC-MuiInputBase-inputAdornedEnd: header-input-base-input-adorned-end
HeaderAC-MuiOutlinedInput-inputAdornedEnd: header-outlined-input-input-adorned-end
HeaderAC-MuiAutoComplete-endAdorment: header-autocomplete-end-adornment
HeaderAC-MuiButtonBase-root: header-button-base-root
HeaderAC-MuiIconButton-root: header-icon-button-root
HeaderAC-MuiAutocomplete-clearIndicator: header-autocomplete-clear-indicator
HeaderAC-MuiIconButton-label: header-icon-button-label
HeaderAC-MuiSvgIcon-root: header-svg-icon-root
HeaderAC-MuiSvgIcon-fontsizeSmall: header-svg-icon-font-size-small
HeaderAC-MuiTouchRipple-root: header-touch-ripple-root
HeaderAC-c1: header-c1
HeaderAC-MuiOutlinedInput-notchedOutline: header-outlined-input-notched-outline
jss7: jss7
HeaderAC-c3: header-c3
